10
G.S.-.-.-.G.-.B.P.B
S.W.BS.-.-.G.-.-.B.-
G.BS.P.B.-.S.-.G.-.-
G.G.B.-.S.W.SG.-.-.-
G.S.-.-.-.S.G.-.-.-
S.W.SG.-.-.G.-.-.A.-
-.S.G.-.BG.-.-.G.-.-
-.-.G.B.P.BG.-.G.-.-
G.G.B.P.B.P.BG.-.G.-
G.G.-.B.G.B.-.G.-.-